1111111111111
10000E0000001
10C0000C00R01
1000000000001
100C0000R0001
1P10000000S01
1111111111111
